xxxxxxxxxxxxxxxxxxxx
x x x x      x x   x
x x     x xx x x x x
x   x x   xx     x x
x x x x x  x xxxxx x
xxxxxxx x xx     x x
x   x   x  xxxxxxxxx
x x   x xxxx       x
x xx xx    x xxx x x
x xx   xx xx xxx x x
x   xx x       x x x
x x xx x xxxxx x x x
x x xxx  x    xx x x
x x     x  xx  x x x
xxxx xxxx xxxxxx x x
xx   xx   xxx    x x
xx xx   xx xx x xx x
xx  x x  x xx xxxxxx
xxx   xx   xx      x
xxxxxxxxxxxxxxxxxxxx